11111111111111111111111111111111
10000000000000000000000000000001
10000000000000000000000000000001
10000000000000000000000000000001
10000000000000000000000000000001
10000000C00000C000000C0C000C0001
1000000C0C0000C000000C00C0C00001
100000CCCCC000C000000C000C000001
10000C00000C00C000000C00C0C00001
1000C0000000C0CCCCCC0C0C000C0001
10000000000000000000000000000001
10000000000000000000000000000001
10000000000000000000000000000001
10000000000000000000000000000001
1P0000000000000000000000000000E1
11111111111111111111111111111111