1111111111111
10010000000C1
0000011111001
10P011E000001
1111111111111