1111111111111
1000000PE00C1
1111111111111