111111111111111111111111111111
100000000000000000000000000001
100000000000000000000000000001
100000000000000000000000000001
100000000000000000000000000001
100000000000000000000000000001
100000000000000000000000000001
100000000000010000000000000001
100000000000000000000000000001
100000000000000000000000000001
100000000000000000000000000001
100000000000000000000000000001
100000000000000000000000000001
100000000000000000000000000001
111111111111111101111111111111
100000000000P000000000000000C1
100000000000000000000000000001
100000000000000000000000000001
100000000000000000000000000001
1000000000000000E0000000000001
100000000000000000000000000001
1000000C0000000000000000000001
100000000000000000000000000001
100000000000000000000C00000001
100000000000000000000000000001
100000000000000000000000000001
100000000000000000000000000001
111111111111111111111111111111