1111111111111
1000CEP000001
1111111111111