111111111111111111111111111111
1P0000000000001010000001000001
111100000000000100000001000011
1E1000000000000000000000100101
111100000000000000000001000011
110000000000000010000001000001
1000000000000001010000000000C1
111111111111111111111111111111