1111111111111
10011000000C1
1000011111001
10P000E100001
1111111111111