1111111111111111111111111111111111
10010000000000C10010000000000000C1
1000000000010001000000000011100001
1000000000000000000000000000000001
1000000000000000000000000000000001
1000000000000000000000000000000001
1000000000000000000000000000000001
1000000000000000000000000000000001
1000000C10000000000011111110100001
1000000000000001000100000000000001
100000C000000001000100000000000001
100000P000000000010000000000000001
1000000000000001000100000000000001
1000000000000001000100000000000001
10010000000000C10010000000000000C1
1000000000011101000000000011100001
100001011111C100000011111110100001
100011E000000001000100000000000001
1111111111111111111111111111111111