11111111111111111
100100000C10000C1
10010000111110111
10010000000000001
10000111110001111
1P0011E00000000C1
11111111111111111