1111111
1PEC011
1000001
1111111