1111111111111111111111111111111111
1001000000000001001000000000000001
1000000000010001000000000011100001
1000000000000000000000000000000001
1000000000000000000000000000000001
10000000000V0000000000000000000001
1000000000000000000000000000000001
1000000000000000V00000000000000001
1000000C10000000000011111110100001
1000000000000001000100000000000001
100000C00000V001000100000V00000001
100000P000000000010000000000000001
1000000000000001000100000000000001
100000000V000001000100000000000001
10010000000000C10010000000V0000001
1000000000011101000000000011100001
100001111111C100000011111110100001
100011E0000000010V0100000000000001
1111111111111111111111111111111111